.............
.............
.............
.............
.............
.............
..#..##..#...
..@#####.##$.
....#.#.##...
......###....
....&%?......
.............