..............
..............
..............
..............
..###$###.....
..#.....#.....
.###..###.##..
.#.####.###...
.@##....#..*..
.#...&..##.#..
.###.%...###..
..###?####....
..............