.............
.............
..#..##..#...
..@#####.##$.
....#.#.##...
......###....
....&%#......
.............