..............
..............
..............
..###...&.).#.
.#(.##..%.###.
.#...#..?..#..
.#######@####.
.#......#...#.
.###.#$.#.###.
...###..#.#.#.
.###.#..###.#.
.#..#####..##.
.*#.#...##.#..
..###....###+.
..............