..............
..............
..............
..#######*##..
.$.#.#..#..#..
.###.#..#####.
..#..?%&...#..
.###.#.....#..
.#...#..#####.
.########.#.#.
....#...##(##.
...###..#.#.#.
..@#.########.
...###........
..............