.............
.............
..#..##..#...
..@#####.##$.
....#.#.##...
......###....
....&##......
.............