...............
...............
...###$###.....
...#.....#.....
..###..###.##..
..#.####.###...
..@##....#..$..
..#...&..##.#..
..###.%...###..
...########....
...............