...##..#..
@#####.##$
..#.#.##..
....###...
..&##.....